abyss=kuilu
acquisition=hankinta, löytö
angular=kulmikas, särmikäs, luiseva
apprehensive=levoton, huolestunut
assessment=arviointi
attend=olla läsnä, osallistua
bargain=löytö, hyvä kauppa
barring=ilman, paitsi
bartering=tavaranvaihto
besiege=piirittää, saartaa
counterfeit=väärennös, epäaito, väärä
debacle=fiasko, (täydellinen epäonnistuminen)
deception=petos, huijaus, vilppi
desolation=autius, tuho, lohduttomuus, yksinäisyys
tribulation=kärsimys, koettelemus, vaikeus
aggregate=kerätä, koota, ryhmittää, keräytymä, kokouma
freckle=pisama,täplittää
absolve=vapauttaa, päästää, julistaa vapaaksi, antaa synninpäästö
implicitly=epäsuorasti
declare=julistaa, ilmoittaa
pretentious=mahtaileva, suurellinen, näyttävä
ostentatious=liiallinen, mahtaileva, huomiotaherättävä, mauton
apt=omiaan, lahjakas, sopiva, pystyvä,taipuvainen
aisle=käytävä, välikäytävä, eteinen
broom=luuta, harja, lakaista
hindsight=jälkiviisaus, jälkikäteen ajateltuna
omit=jättää pois, jättää huomiotta, laiminlyödä
myriad=lukematon, suuri määrä, suunnaton määrä
concatenate=ketjuttaa, liitostaa
equivocate=johtaa harhaan, harauttaa, pyöritellä
asinine=typerä, aasimainen
vicinity=suuruusluokka, kokoluokka, läheisyys
cling=takertua, tarrautua
amicable=ystävällinen, sovinnollinen, sopuisa
confer=antaa, myöntää, keskustella, neuvotella
perplexity=hämmennys, pula
usher=ohjata, opastaa, ennakoida, paikannäyttäjä
survey=valvoa, tarkkailla, yleissilmäys
concise=kireä, kapea, ytimekäs, lyhytsanainen
equanimity=tyyneys, mielentyyneys, maltti
placate=rauhoittaa, lepytellä, tyynnyttää, asettaa
dismantle=purkaa, hajottaa
bogey=näyte, kohde, maali(armeija)
tantamount=samaa merkitse kuin, käytännössä sama
conciliatory=sovinnollinen
directive=toimintaohje
assignment=tehtävä, toimeksianto, osoitus, työtehtävä, määrittely
underscore=alaviiva, alleviivaus, alleviivata
punctuation=välimerkit, pilkutus
legibility=luettavuus
obfuscation=tarkoituksenmukainen monimutkaistaminen
parenthesis=sulkeet, kaarisulkeet, sulkumerkit
indentation=sisentäminen
brevity=lyhytaikaisuus
arbitrary=mielivaltainen, satunnainen, umpimähkäinen
terse=niukkasanainen, töksähtävä, ytimekäs, lakoninen
ruse=juoni, temppu, kavala suunnitelma, pila
dungeon=vankityrmä, tyrmä
immerse=upottaa
treatise=tutkielma
volatile=räjähdysherkkä, vaihteleva, epävakaa
lest=ettei, jottei
aggravating=raivostuttava, raskauttava
essentially=pääasiallisesti, pohjimmiltaan, periaatteessa
inflict=aiheuttaa, tuottaa, langettaa
eschew=välttää, karttaa
quirky=kumallinen, omituinen:wq
parentheses=sulkeet, kaarisulkeet
punctuation=vÃ¤limerkit, pilkutus
discern=huomata, havaita, nÃ¤hdÃ¤
indentation=sisennys, kolo
align=asettaa riviin, linjata, tasata
extensively=laajasti, kattavasti
terse=niukkasanainen, tÃ¶ksÃ¤htÃ¤vÃ¤, ytimekÃ¤s, lakoninen
brevity=lyhytaikaisuus
arbitrarily=sattumanvaraisesti, umpimÃ¤hkÃ¤isesti, mielivaltaisesti
condense=lyhentÃ¤Ã¤, supistaa, tiivistÃ¤Ã¤, lauhduttaa
adjacent=lÃ¤heinen, rinnakkainen, viereinen
underscore=alleviivaus, alaviiva
transaction=vuorovaikutus, liiketoimi, rahansiirto, tapahtuma:
proficient=taitava, sujuva, pÃ¤tevÃ¤
dismiss=vÃ¤hÃ¤tellÃ¤, erottaa(tyÃ¶ntekijÃ¤), lÃ¤hettÃ¤Ã¤ pois
convolute=monimutkaistaa, tehdÃ¤ kierteiseksi
neophyte=aloittelija, noviisi, uusi kÃ¤Ã¤nnynnÃ¤inen
coax=houkutella, taivutella, suostutella, maanitella
wary=varovainen, arka, pelokas
slant=viettÃ¤Ã¤, olla vinossa, suunnata, painottaa
encumber=estÃ¤Ã¤, haitata
sparsely=niukasti, harvasti, vÃ¤ljÃ¤sti
reside=asustaa, oleskella, asua
